{
    "layout": [
        "                                       ",
        "  #P   #                               ",
        "  # #  #  ##########    ############   ",
        "  # #  #  #         E   #        # #   ",
        "  # #  #  # #######     #  ####### #   ",
        "  # #  #  #       #      # # #         ",
        "    #    S#       #    # # # #         ",
        "  ##########      #### # # # #  #####  ",
        "  #        #                        #  ",
        "  # ###### # ### ###      ##### #####  ",
        "  # #    # # #     #      #         #  ",
        "  # #    #   # ### #      #         #  ",
        "  # #    # # #    E#      #         #  ",
        "  # # ## # # ### ###      #    E    #  ",
        "  # #    # #              #         #  ",
        "  # #    # #              ###########  ",
        "  # #E   # #                           ",
        "  # ##  ## #                           ",
        "  #        #                           ",
        "  ####  ############# # # # ########## ",
        "                      # # #          G ",
        "                                       "
    ],
    "enemies": {
        "E": {
            "dice": "d6",
            "interval": 2,
            "image": "enemy_level_2.png"
        }
    },
    "items": {
        "S": {
            "name": "sword",
            "image": "proto_sword.png"
        }
    },
    "background": "level1_background.webp",
    "music": "TreeIsShift.mp3"
}