{
    "layout": [
        "########################################",
        "##P                         #        E##",
        "## ### ##### ##### ###### ### ### ### ##",
        "##        #     #    #  #     # # #   ##",
        "##       ### # ### #### # # # ### ### ##",
        "##       # # # #      # #   #E    #   ##",
        "## ### # # # # ## ### # # # ####### ###",
        "##     #   # #      # # #         #   ##",
        "###### ### # ###### # # # ####### ### ##",
        "##   # #   #      # #     #E    # #   ##",
        "## # ### # ###### # ##  ####### # #####",
        "## #E        #                  #     ##",
        "## #### ## ### ###   ####  ######### ##",
        "##               #   #       #       ##",
        "#### ##### ####### ### ##### # ## ## ##",
        "##     #       #     # #       #G    ##",
        "## ### ### ### ##### # # # ### #######",
        "## #     # # # #    E#   # # #       ##",
        "## ##### # # # # ##### ### # ## ## # ##",
        "##       #   # #       #               ",
        "########################################"
    ],
    "enemies": {
        "E": {
            "dice": "d6",
            "interval": 2,
            "image": "enemy_level_2.png"
        }
    },
    "items": {
        "S": {
            "name": "sword",
            "image": "proto_sword.png"
        }
    },
    "music": "CogIsPush.mp3"
}