{
    "layout": [
        "                                       ",
        "  #    #                               ",
        "  # #  #  ##########    ############   ",
        "  # #  #  #         E   #        # #   ",
        "  # #  #  # #######     #  ####### #   ",
        "  # #  #  #       #      # # #         ",
        "    #     #       #    # # # #         ",
        "  ##########      #### # # # #  #####  ",
        "  #        #                        #  ",
        "  # ###### # ### ###      ##### #####  ",
        "  # #    # # #     #      #         #  ",
        "  # #    #   # ### #      #         #  ",
        "  # #    # # #    E#      #         #  ",
        "  # # ## # # ### ###      #    E    #  ",
        "  # #    # #              #         #  ",
        "  # #    # #              ###########  ",
        "  # #E   # #                           ",
        "  # ##  ## #                           ",
        "  #        #                           ",
        "  ####  ############# # # # ########## ",
        "                      # # #            ",
        "                                       "
    ],
    "player_start": [5,5],
    "end_goal": [24,4],
    "enemies": {
        "E": {
            "dice": "d6",
            "interval": 2
        }
    }
}