{
    "layout": [
        "########################################",
        "##                          #         ##",
        "## ### ##### ##### ###### ### ### ### ##",
        "##        #     #    #  #     # # #   ##",
        "##       ### # ### #### # # # ### ### ##",
        "##       # # # #      # #   #     #   ##",
        "## ### # # # # ## ### # # # ####### ###",
        "##     #   # #      # # #         #   ##",
        "###### ### # ###### # # # ####### ### ##",
        "##   # #   #      # #     #     # #   ##",
        "## # ### # ###### # ##  ####### # #####",
        "## #         #                  #     ##",
        "## ####### ### ###   ####  ######### ##",
        "##               #   #       #       ##",
        "#### ##### ####### ### ##### # ##### ##",
        "##     #       #     # #       #     ##",
        "## ### ### ### ##### # # # ### #######",
        "## #     # # # #     #   # # #       ##",
        "## ##### # # # # ##### ### # ####### ##",
        "##       #   # #       #               ",
        "########################################"
    ],
    "player_start": [5,5],
    "end_goal": [24,4],
    "enemies": [
        {
            "position": [22,3],
            "dice": "d6",
            "interval": 2
        }
    ]
}